XXXXXXXXXXXXXXXX
X1.............X
X..............X
X...XXXX.......X
X..............X
X......W...L...X
XXXX..XXXXXXX..X
X..............X
X..............X
X.....2........X
X...XXXXX......X
XXXXXXXXXXXXXXXX